af      -   Afrikaans,
ar      -   Arabic,
bg      -   Bulgarian,
bn      -   Bengali,
cs      -   Czech,
da      -   Danish,
de      -   German,
el      -   Greek,
en      -   English,
es      -   Spanish,
et      -   Estonian,
fa      -   Persian,
fi      -   Finnish,
fr      -   French,
gu      -   Gujarati,
he      -   Hebrew,
hi      -   Hindi,
hr      -   Croation,
hu      -   Hungarian,
id      -   Indonesian,
it      -   Italian,
ja      -   Japanase,
kn      -   Kannada,
ko      -   Korean,
lt      -   Lithuanian,
lv      -   Latvian,
mk      -   Macedonian,
ml      -   Malayalam,
mr      -   Marathi,
ne      -   Nepali,
nl      -   Dutch,
no      -   Norwegian,
pa      -   Punjabi,
pl      -   Polish,
pt      -   Portuguese,
ro      -   Romanian,
ru      -   Russian,
sk      -   Slovak,
sl      -   Slovenian,
so      -   Soomaali,
sq      -   Albanian,
sv      -   Swedish,
sw      -   Swahili,
ta      -   Tamil,
te      -   Telugu,
th      -   Thai,
tl      -   Tagalog,
tr      -   Turkish,
uk      -   Ukrainian,
ur      -   Urdu,
vi      -   Vietnamese,
zh-cn   -   Chinese simplified,
zh-tw   -   Chinese traditional